n n n n n n n n n n n n n n n n n n n n n n n n n n n n n n n n n n n n n n n n n n n n n n n n n n n n n n n
n n n n n n n n n n n n n n n n n n n n n n n n n n n n n n n n n n n n n n n n n n n n n n n n n n n n n n n
n n n n n n n n n n n n n n n n n n n n n n n n n n n n n n n n n n n n n n n n n n n n n n n n n n n n n n n
n n n n n n n n n n n n n n n n n n n n n n n n n n n n n n n n n n n n n n n n n n n n n n n n n n n n n n n
n n n n n n n n n n n n n n n n n n n n n n n n n n n n n n n n n n n n n n n n n n n n n n n n n n n n n n n
n n n n n n n n n n n n n n n n n n n n n n n n n n n n n n n n n n n n n n n n n n n n n n n n n n n n n n n
n n n n n n c d I I I G n G G G G G n G G G J G c n n n n n n n n n n n n n n n n n n n n n n n n n n n n n n
n n n n n n d I I I I G n G G G G G n G G G J G G n n n n n n n n n n n n n n n n n n n n n n n n n n n n n n
n n n n n n f f I I I G R G r G r G R G j G J 3 b n n n n n n n n n n n n n n n n n n n n n n n n n n n n n n
n n n n n n d I I I I G n G G G G G n G G G J G G n n n n n n n n n n n n n n n n n n n n n n n n n n n n n n
n n n n n n c d I I I G n G G G G G n G G G J G c n n n n n n n n n n n n n n n n n n n n n n n n n n n n n n
n n n n n n n n n n n n n G G G G G n n n n n n n n n n n n n n n n n n n n n n n n n n n n n n n n n n n n n
n n n n n n s a a a a a R G G G G G n G G G W G c n n n n n n n n n n n n n n n n n n n n n n n n n n n n n n
n n n n n n s G c G G G n G G G G G n G G G W G G n n n n n n n n n n n n n n n n n n n n n n n n n n n n n n
n n n n n n s G G r 2 G n G r G r G R G w G W 1 g n n n n n n n n n n n n n n n n n n n n n n n n n n n n n n
n n n n n n s G c G G G n G G G G G n G G G W G G n n n n n n n n n n n n n n n n n n n n n n n n n n n n n n
n n n n n n d d d d d d G G G G G G n G G G W G c n n n n n n n n n n n n n n n n n n n n n n n n n n n n n n
n n n n n n n n n n n n n n n R n n n n n n n n n n n n n n n n n n n n n n n n n n n n n n n n n n n n n n n
n n n n n n n n n n n n n n n D n n n n n n n n n n n n n n n n n n n n n n n n n n n n n n n n n n n n n n n
n n n n n n n n n n n n n n n B n n n n n n n n n n n n n n n n n n n n n n n n n n n n n n n n n n n n n n n
n n n n n n n n n n n n n n n G n n n n n n n n n n n n n n n n n n n n n n n n n n n n n n n n n n n n n n n
n n n n n n n n n n n n n n n G n n n n n n n n n n n n n n n n n n n n n n n n n n n n n n n n n n n n n n n
n n n n n n n n n n n n n n n G n n n n n n n n n n n n n n n n n n n n n n n n n n n n n n n n n n n n n n n
n n n n n n n n n n n n n n n R n n n n n n n n n n n n n n n n n n n n n n n n n n n n n n n n n n n n n n n
n n n n n n n n n n n n n n n T n n n n n n n n n n n n n n n n n n n n n n n n n n n n n n n n n n n n n n n
n n n n n n n n n n n n n n n F n n n n n n n n n n n n n n n n n n n n n n n n n n n n n n n n n n n n n n n
n n n n n n c c c c c c c c c G c c c c c c c c c c c c c c c c c c c c c c c c c c c c c c c c c n n n n n n
n n n n n n c G G G G G G G G G G G G G G G G G G G G G G G G G G G G G G G G G G G G G G G G G c n n n n n n
n n n n n n c G G G G G G G G G G G G G G G G G G G G G G G G G G G G G G G G G G G G G G G G G c n n n n n n
n n n n n n c G G n n n n n n n n n n n n n n n n n n n n n n n n n n n n n n n n n n n n n G G c n n n n n n
n n n n n n c G G n G G G G r G G G G G G G G G G G G G G G G G G G G G G G G G G G G G G n G G c n n n n n n
n n n n n n c G G n n n n n n n n n n B n n n n n n n n n n n n n n n n n n n n n n n n n n G G c n n n n n n
n n n n n n c G G n G G G G G G G G G G G G G G G G G G G G G G G G G G G G G G G G G G G n G G c n n n n n n
n n n n n n c G G n G G G G G G G G G G G G G G G G G G G G G G G G G G G G G G G G G G G n G G c n n n n n n
n n n n n n c G G n j G G G G G G G G G G G G G G G G G G G G G G G G G G G G G G G G G G B G G c n n n n n n
n n n n n n c G G n G G G G G G G G G G G G G G G G G G G G G G G G G G G G G G G G G G G n G G c n n n n n n
n n n n n n c G G n G G G G G G G G G G G G G G G G G G G G G G G G G G G G G G G G G G G n G G c n n n n n n
n n n n n n c G G n n n n n n n n n n n n n n n n n G n n n n n n n n n n n n n n n n n n n G G c n n n n n n
n n n n n n c G G n n n n n n n n n n n n n n n n n G n n n n n n n n n n n n n n n n n n n G G c n n n n n n
n n n n n n c G G n n n n n n n n n n n n n n n n n G n n n n n n n n n n n n n n n n n n n G G c n n n n n n
n n n n n n c G G n G G G G G G G G G G G G G G G G G G G G G G G G G G G G G G G G G G G n G G c n n n n n n
n n n n n n c G G n G G G G G G G G G G G G G G G G G G G G G G G G G G G G G G G G G G G n G G c n n n n n n
n n n n n n c G G n G G G G G G G G G G G G G G G G G G G G G G G G G G G G G G G G G G G n G G c n n n n n n
n n n n n n c G G n G G G G G G G G G G G G G G G G G G G G G G G G G G G G G G G G G G G n G G c n n n n n n
n n n n n n c G G n G G G G G G G G G G G G G G G G G G G G G G G G G G G G G G G G G G G n G G c n n n n n n
n n n n n n c G G n G G G G G G G G G G G G G G G G G G G G G G G G G G G G G G G G G G G n G G c n n n n n n
n n n n n n c G G n n n n n G n n n n n n G n n n G n n n n G n n n n n n n n n n G n n G n G G c n n n n n n
n n n n n n c G G n n n n n G n n n n n n s n n n G n n n n s n n n n n n n n n n G n n G n G G c n n n n n n
n n n n n n c G G n n n n n G n n n n n n s n n n G n n n n s n n n n n n n n n n G n n G n G G c n n n n n n
n n n n n n c G G n n n n n G n n n n n n s n n n T n n n n s n n n n n n n n n n G n n G n G G c n n n n n n
n n n n n n c G G n n n n n G n n n n n n s n n n G n n n n s a a a a a a a a a a G n n G n G G c n n n n n n
n n n n n n c G G n n n n n G n n n n n n s n n n n n n n n s n n n n n n n n n n n n n G n G G c n n n n n n
n n n n n n c G G n G G G G G n n n n n n d d d d G G a a a a n n n n n n n n n n n n n G n G G c n n n n n n
n n n n n n c G G n G n n n n n n n n n n n n n n n n n n n n n n n n n n n n n n n n n G n G G c n n n n n n
n n n n n n c G G n G n n n n n n G G G n n n n n n n n n n n n n n n n n n n n n n n n G n G G c n n n n n n
n n n n n n c G G n G G G G G G G G n G n n n n n n n n n n n n n n n n n n n n n n n n G n G G c n n n n n n
n n n n n n c G G n n n n n n n n n n G n n n n n n n n n n n n n n n n n n n n n n n n G n G G c n n n n n n
n n n n n n c G G n n n n n n n n n n J n n n n n n n n n n n n n n n n n n n n n n n n G n G G c n n n n n n
n n n n n n c G G n n n n n n n n n n G n n n n n n n n n n n n n n n b G G n n n n n n G n G G c n n n n n n
n n n n n n c G G n n n n n n n n n n G n n n n n n n n n n n n n n n G G G B G G G G G G n G G c n n n n n n
n n n n n n c G G n n n n n n n n n n G n n n n n n n n n n n n n n n c G G n n n n n n n n G G c n n n n n n
n n n n n n c G G n n n n n n n n n n G n n n n n n n n n n n n n n n n n n n n n n n n n n G G c n n n n n n
n n n n n n c G G n n n n n n n n n n G b n n n n n n n n n n n n n n n n n n n n n n n n n G G c n n n n n n
n n n n n n c G G n n n n n n n n n n n n n n n n n n n n n n n n n n n n n n n n n n n n n G G c n n n n n n
n n n n n n c G G n n n n n n n n n n n n n n n n n n n n n n n n n n n n n n n n n n n n n G G c n n n n n n
n n n n n n c G G n n n n n n n n n n n n n n n n n n n n n n n n n n n n n n n n n n n n n G G c n n n n n n
n n n n n n c G G G G G G G G G G G G G G b G G G G G G G G G G G G G G G G G G G G G G G G G G c n n n n n n
n n n n n n c G G G G G G G G G G G G G G G G G G G G G G G G G G G G G G G G G G G G G G G G G c n n n n n n
n n n n n n c c c c c c c c c c c c c c c c c c c c c c c c c c c c c c c c G c c c c c c c c c c n n n n n n
n n n n n n n n n n n n n n n n n n n n n n n n n n n n n n n n n n n n n n G n n n n n n n n n n n n n n n n
n n n n n n n n n n n n n n n n n n n n n n n n n n n n n n n n n n n n n n G n n n n n n n n n n n n n n n n
n n n n n n n n n n n n n n n n n n n n n n n n n n n n n n n n n n n n n n G n n n n n n n n n n n n n n n n
n n n n n n n n n n n n n n n n n n n n n n n n n n n n n n n n n n n n n n G n n n n n n n n n n n n n n n n
n n n n n n n n n n n n n n n n n n n n n n n n n n n n n n n n n n n n n n G n n n n n n n n n n n n n n n n
n n n n n n n E G G G G G G G G G G G G G G G G G G G G G G G G G G G G G G G G G G G G G G G G n n n n n n n
n n n n n n n G G G G G G G G G G G G G G G G G G G G G G G G G G G G G G G G G G G G G G G G G n n n n n n n
n n n n n n n G G G G G G G G G G G G G G G G G G G G G G G G G G G G G G G G G G G G G G G G G n n n n n n n
n n n n n n n G G G G G G G G G G G G G G G G G G G G G G G G G G G G G G G G G G G G G G G G G n n n n n n n
n n n n n n n n n n R n n n n n n n n n n n n n n n n n n n n n n n n n n n n n n n n n n n n n n n n n n n n
n n n n n n n n n n V n n n n n n n n n n n n n n n n n n n n n n n n n n n n n n n n n n n n n n n n n n n n
n n n n n n n n n n n n n n n n n n n n n n n n n n n n n n n n n n n n n n n n n n n n n n n n n n n n n n n
n n n n n n n n n n n n n n n n n n n n n n n n n n n n n n n n n n n n n n n n n n n n n n n n n n n n n n n
n n n n n n n n n n n n n n n n n n n n n n n n n n n n n n n n n n n n n n n n n n n n n n n n n n n n n n n
n n n n n n n n n n n n n n n n n n n n n n n n n n n n n n n n n n n n n n n n n n n n n n n n n n n n n n n
n n n n n n n n n n n n n n n n n n n n n n n n n n n n n n n n n n n n n n n n n n n n n n n n n n n n n n n
n n n n n n n n n n n n n n n n n n n n n n n n n n n n n n n n n n n n n n n n n n n n n n n n n n n n n n n